end: preplexity train = 2102.78, test = 2336.37 coherence = 0.63 uniq_top_of_topics = 0.52
москва : москва банк банка ооо россия лицензия номер регистрация
налоговый : налоговый налог рф ст налогоплательщик сумма уплата порядок
история : кредитный история бюро информация организация замщик закон каталог
основание : организация кредитный россия основание государственный банка управление регион
председатель : председатель правление банк оао заместитель кб год зао
важный : важный потребитель доверие завоевание упрочение связь время являться
нормативный : банка россия нормативный банковский надзор деятельность порядок акт
миллиард : рубль миллиард составить миллион банк увеличиться сумма средство
управлять : компания управлять адрес год решение фактический требование телефон
сила : россия банка день сила год указание изменение официальный
вклад : вклад банк банка система рубль физический вкладчик банковский
ассоциация : ассоциация банковский банк россия президент банка российский арба
отчтность : отчтность финансовый мсфо организация бухгалтерский аудит аудитор оценка
общество : общество ответственность акционерный ограниченный миллион рф сентябрь открытый
ставка : ставка процентный уровень рефинансирование депозит цб снижение годовой
платж : платж система платжный счт расчт карта средство услуга
страхование : страхование страховой страхов страховщик обязательный премия участник выплата
валютный : валютный рынок ограничение политика операция российский регулирование мировой
рабочий : рабочий день неделя время работа норма труд работник
фонд : фонд пенсионный негосударственный пенсия накопление средство тысяча год
опыт : опыт международный рынок страна тема работа иностранный стол
акция : акция рынок размещение акционер инвестор капитал фондовый увеличение
защита : защита система информация решение отношение право безопасность дать
совет : совет россия деятельность минфин аудиторский принять февраль ответственный
осуществление : банковский банк осуществление операция лицензия россия зарегистрировать кредитный
расход : расход доход сумма налог средство прибыль затрата реализация
риска : риска риск финансовый оценка управление система банковский операционный
филиал : филиал банка банк миллион банковский офис деятельность кредитный
ценный : бумага ценный рынок ипотечный финансовый облигация доход операция
производство : производство предприятие продукция вид деятельность цена период сравнение
связь : связь россия мера банк важный деятельность город новый
договор : договор право закон случай лицо условие ст имущество
валюта : валюта рубль курс иностранный национальный банк использовать капитал
сотрудник : сотрудник работа клиент специалист персонал программа обучение работать
разработать : разработать развитие наука система государственный защитить экономический библиогра
доллар : доллар год миллион евро компания составлять годовой тысяча
внутренний : внутренний контроль качество аудит проверка организация система уровень
товар : товар цена услуга заказ оплата покупатель условие деньга
денежный : денежный средство счт перевод деньга операция обращение количество
действующий : капитал действующий число организация уставный иметь количество иностранный
подразделение : подразделение организация управление работа руководитель головной операционный место
обязательство : обязательство средство актив счт резерв вексель период операция
кредит : кредит банка кредитование банк ипотечный кредитный замщик потребительский
московский : московский банк промышленный правительство июнь район русский государственный
состоять : время состоять момент целое создание ценность сложный смочь
баланс : баланс рубль следовать зао допустить ошибка выдача консультант
юридический : лицо юридический физический счт реестр деятельность сведение право
информационный : система информационный информация процесс управление дать безопасность решение
агентство : агентство рейтинг решение требование работа коллекторский кредитор ипотечный
сотрудничество : финансовый сотрудничество развитие международный область совместный инвестиционный национальный
социальный : социальный экономический государственный государство уровень отношение программа труд
конкуренция : банковский рынок банка российский банк услуга развитие конкуренция
подготовка : подготовка финансовый ход проведение план обучение область дополнение
прошлое : год прошлое новый кризис считать будущее стать конец
федерация : федерация российский федеральный рф закон вопрос положение изменение
называть : год называть начало обращение оборот тысяча выпуск необходимость
специальный : специальный счт использование вид отдельный раздел возможность получение
член : член палата принять собрание заседание рассмотреть межрегиональный общий
технология : система технология компания банковский решение число центр возможность
директор : директор генеральный руководитель управление рф заместитель деловой состояться
учт : учт бухгалтерский расчт учтный метод организация изменение положение
ранее : ранее решение год выпуск результат список изменение металл
полностью : существовать говорить полностью никакой курс стоить должный глава
вести : финансовый стабильность вести обеспечение улучшение значение комитет поддержание
финансирование : финансирование предприятие получить малое путм программа средство ресурс
обслуживание : клиент банка обслуживание услуга банковский продукт банк офис
мир : мир компания рынок самый страна стать время большой
документ : документ информация проведение электронный требование решение необходимый проверка
сделка : сделка рынок контрагент участник покупатель являться приобретение инвестор
эксперт : эксперт рынок деньга компания банкир новый рейтинг дело
профессиональный : деятельность профессиональный аудиторский аудитор аудит услуга проведение качество
коммерческий : организация кредитный коммерческий банк банка банковский операция требование
начинать : компания начинать место последний найти ряд самый очень
темп : рост год темп рынок развитие цена сектор инфляция
стандарт : стандарт международный деятельность качество провести актуальный практика работа
проект : проект программа реализация национальный развитие рамка создание область
представитель : представитель участие российский конференция принять участник вопрос правительство
субъект : субъект деятельность государственный экономический малое формирование форма предпринимательство
стоимость : стоимость актив оценка компания основный объект рыночный случай
единый : финансовый единый европейский служба пространство инструмент процесс изменение
сеть : сеть карта количество бизнес розничный платжный торговый крупный
занимать : год работать занимать должность начальник отдел институт бизнес
стратегия : стратегия управление бизнес развитие стратегический направление корпоративный инвестиционный
учреждение : банка учреждение государственный участие территориальный развитие норматив положение
учитывать : банк учитывать внешний город мера общественный применение закон
размер : размер капитал взнос менее собственный таблица средство принять
орган : орган федеральный закон право рф служба решение сведение
сша : страна сша экономика мировой рынок международный государство экономический
аналогичный : чистый аналогичный тысяча средство дать собственный доход процент
представлять : представлять информация интерес дать сторона отчт некоторый должный
группа : группа компания финансовый предприятие уралсиб структура актив бизнес
инвестиция : инвестиция рынок российский страна инвестор инвестиционный экономика государственный
следующий : россия следующий банка организация требование временной администрация управление
центральный : центральный банк банка россия рф российский национальный цб
достигнуть : достигнуть год крупный число банковский система сравнение результат
решить : проблема стать решить самый должный деньга очень шаг
исследование : экономика исследование экономический оценка результат анализ фактор показатель
территория : территория российский право услуга реализация место иностранный представительство
население : население доход год страна область уровень потребительский гражданин
поддержка : поддержка развитие малое бизнес работа система региональный страна